:Room1
|##########
|4        #
|# ###### #
|#     ## 7
|# ### ## #
|# ### ## #
|1        #
|####3#####
:Room2
|##########
|#        4
|#  #### ##
|##    #  #
|#  # ### #
|# ###### #
|#    #   1
|####5#####
:Room3
|####5#####
|#        #
|# ###### #
|# ###### 6
|# ###### #
|# ###### #
|#        #
|##########
:Room4
|####3#####
|#        #
|# ###### #
|6 ###### #
|# ###### #
|# ###### #
|#        #
|##########
:Room5
|##########
|#        #
|# ###### #
|7 #    # #
|# #    # #
|# ###### #
|#        #
|##########